0.0S........00.....0
..00..00.......0....
...0...........0....
0...............00..
..0....00.0.0..0....
.........0...0......
..0......00......0..
............0.0...00
...0.00.............
.....0..0000........
.......00........F..
..0..........0...00.
0......0...0.....00.
....0..0........0.0.
..........0...0....0
.......0....0.00.0..
00....00.......0...0
0.0...0..0......0..0
0..0................
.0..............00..