.......0S.
...00...0.
..0.0.....
..0.0F0...
0.........
0..0......
.0.....0..
..0..0....
..........
....0.....