..........0...0.....
....0..0...0...0...0
.....0...0...0......
.0..0..0....0......0
...0......0....0..0S
.........0...0.0000.
............0....00.
..0........0F0......
...........0........
........0........0..
....0.0...0.........
........0....0......
..0........0.0...0.0
.....0......0....0..
.0......0........0..
...........0.0.0....
..00..0..........0..
..0........0........
.00....0............
...............0..0.