.........0....0
.....0.0.0....0
0..........0S..
....0....0.....
..0...0F.0...0.
...............
0..0....000....
.....0.0.......
..0....00......
.0....0......00
......0......0.
........0....0.
....0...0....0.
...0...........
...0..0........